          #####    
          #   #    
          #  @#    
         ##@  ###  
         # @ @  #  
######   #A## # ###
#oo  ##### ## #   #
#oo          #  # #
#oo  ## # ### #####
#########     #    
        #######    
