 ###  ######
## ## #  oo#
#   ###  oo#
# @@     oo#
# @ # #  oo#
# @ # ###oo#
#A @# @ ####
# @ #@  #   
#  @  @ #   
#   ##  #   
#########   
