########            
#oooo  #            
#oooo  ############ 
#oooo   @ @  #    # 
#oooo  # @  @#@@@ # 
#oooo  # @     @  # 
########@ @ @# @@ # 
       #     # @  # 
       ######### ## 
       ##    #    # 
       ##   @     # 
       #A  @@#@@  # 
       ##    #    # 
        ########### 
